11111111111101
12222222221101
13111111121101
12111111121101
12222222220001
11121111121111
00121111121111
00121122222222
00121121111101
00121121111101
00122220000000
00101121101114
11101121101444
00001121101444
11111121101444
11111121101111
00001121100000
11101121101111
00101121101111
00122222222225
00121111121111
00121111121111
00122221122221
00111121111121
11111121111121
12222221122222
12111121121111
13111121121111
12222222220001
11111111111101
00000000000101

