11111111111111
12222222221122
12111121121121
12111121121121
12222321122221
12111121111121
12111121111121
12112222222221
12112111101111
12112111101111
02222220000000
12111121101114
12111121101444
12111121101444
12222221101444
10111121101111
10111121100000
10001121101111
11101121101111
11101122222221
00001121111121
10111121111121
10111121122225
12222221121121
12112111121121
12112111121121
12112322221122
12111111121111
12111111121111
12222222222222
11111111111111
