11111100000000
12222100111111
12112100122222
12112100121111
12112111121111
13112222222221
12111101111121
12111101111121
02222222222222
11121121101111
00121121101111
00121121100000
00121121101114
11121121101444
00022220001444
11121121101444
00121121101111
00122221100000
00111121101111
11111121101111
12222222222222
12111111121111
12111111121111
13112222222225
12112112111111
12112112111111
02222112222222
12111111111121
12111111111121
12222222222221
11111111111111
