11111111111111
12222222222221
12111121111121
13111121111121
12111121111121
12222222222222
12111121121111
12111121121111
12222221122221
11111121111101
00000121111101
00000121100000
00000121101114
11111121101444
00000020001444
11111121101444
00000121101111
00000121100000
00000121101111
12222222222221
12111121111121
12111121111121
13221122222225
11121121121111
11121121121111
12222221122221
12111111111121
12111111111121
12222222222222
11111111111111
