11111100000000
12222100000000
12112111111111
12112222222222
13111111121111
12111111121111
12222222222222
12111121121111
12111121121111
12222221122221
12111121111101
12111121111101
02221121100000
11121121101114
00121121101444
00122220001444
00121121101444
11121121101111
02221121100000
12111121111101
12111121111101
12222221122221
12111121121111
12111121121111
12222222222225
12111111121111
13111111121111
12112222222222
12112111111111
12222100000000
11111100000000
