1111119999999999999999111111
1222219999999999999999122221
1211211111111111111111121121
1211222222222222222222221121
1311111112111111112111111131
1211111112111111112111111121
1222222222222222222222222221
1211112112111111112112111121
1211112112111111112112111121
1222222112222112222112222221
1211112111110110111112111121
1211112111110110111112111121
6222112114000000004112112226
1112112110111111110112112111
9912112110199999910112112199
9912222000199999910002222199
9912112110199999910112112199
1112112110111111110112112111
6222112114000000004112112226
1211112111110110111112111121
1211112111110110111112111121
1222222112222112222112222221
1211112112111111112112111121
1211112112111111112112111121
1222222222222552222222222221
1211111112111111112111111121
1311111112111111112111111131
1211222222222222222222221121
1211211111111111111111121121
1222219999999999999999122221
1111119999999999999999111111
1111119999999999999999111111
1222210011111111111100122221
1211210012222222222100121121
1211210012111111112100121121
1211211112111111112111121121
1311222222222112222222221131
1211110111112112111110111121
1211110111112112111110111121
6222222222222222222222222226
1112112110111111110112112111
9912112110111111110112112199
9912112114000000004112112199
9912112110111111110112112199
1112112110199999910112112111
6002222000199999910002222006
1112112110199999910112112111
9912112110111111110112112199
9912222114000000004112222199
9911112110111111110112111199
1111112110111111110112111111
1222222222222222222222222221
1211111112111111112111111121
1211111112111111112111111121
1311222222222552222222221131
1211211211111111111121121121
1211211211111111111121121121
6222211222222222222221122226
1211111111112112111111111121
1211111111112112111111111121
1222222222222112222222222221
1111111111111111111111111111
1111111111111111111111111111
1222222222112222112222222221
1211112112112112112112111121
1211112112112112112112111121
1222232112222112222112322221
1211112111112112111112111121
1211112111112112111112111121
1211222222222112222222221121
1211211110111111110111121121
1211211110111111110111121121
6222222004000000004002222226
1211112110111111110112111121
1211112110199999910112111121
1211112110199999910112111121
1222222110199999910112222221
1011112110111111110112111101
1011112114000000004112111101
1000112110111111110112110001
1110112110111111110112110111
1110112222222112222222110111
6000112111112112111112110006
1011112111112112111112111101
1011112112222552222112111101
1222222112112112112112222221
1211211112112112112111121121
1211211112112112112111121121
1211232222112222112222321121
1211111112111111112111111121
1211111112111111112111111121
1222222222222222222222222221
1111111111111111111111111111
1111111111116116111111111111
1222222222110110112222222221
1311111112110110112111111131
1211111112110110112111111121
1222222222000110002222222221
1112111112111111112111112111
9912111112111111112111112100
9912112222222222222222112100
9912112111110110111112112100
9912112111110110111112112100
9912222004000000004002222100
9910112110111111110112110100
1110112110199999910112110111
6000112110199999910112110006
1111112110199999910112111111
1111112110111111110112111111
6000112114000000004112110006
1110112110111111110112110111
9910112110111111110112110199
9912222222222552222222222199
9912111112111111112111112199
9912111112111111112111112199
9912222112222112222112222199
9911112111112112111112111199
1111112111112112111112111111
1222222112222222222112222221
1211112112111111112112111121
1311112112111111112112111131
1222222222000110002222222221
1111111111110110111111111111
9999999999916116199999999999
